1 0 0 0 0 0 0 0 0 0 0 0 0 0 1 	 
4 1 2 2 2 4 4 4 4 4 2 2 2 1 4 
4 2 4 4 4 2 4 1 4 2 4 4 4 2 4 	 
4 2 4 4 4 4 4 1 4 2 4 4 4 4 4 	 
4 2 4 2 2 2 4 1 4 2 4 2 2 2 4 	 
4 2 4 4 4 2 4 1 4 2 4 4 4 2 4 	 
4 4 2 2 2 4 4 4 4 4 2 2 2 4 4 	 
3 3 3 3 3 3 3 3 3 3 3 3 3 3 3 	